11111111111111111111111111111111111
1E00000CCCCC11111111111000000000001
1P000000000000000000000011111111111
11111111111111111111111CCCCCCCCCCC1
11111111111111111111111111111111111

