11111111111111111111111111111111111111111111111111111111111111111111111111111
1CCCCCCCCCCCCCCCCCCCCCCCCCCCCCCCCCCCCCCCCCCECCCCCCCCCCCCCCCCCCCCCCCCCCCCCCCC1
111111111111111111111111111111111111111111111111111111111111111111111111111C1
111111111111111111111111111111111111111111111CCCCCCCCCCCCCCCCCCCCCCCCCCCCCCC1
111111111111111111111111111111111111111111111C1111111111111111111111111111111
111111111111111111111111111111111111111111111CCCCCCCCCCCCCCCCCCCCCCCCCCCCCCP1
11111111111111111111111111111111111111111111111111111111111111111111111111111
