11111111111111111111111111111111111
1000000000000C00010000000000000C001
1P0000010000M0000000000000001000C01
10000000000M00000100C00000001111111
10000000000000000100000000000000001
10000000C000M00001M0000000E00000001
1000000000000000010000000000000M001
10000C00000000000100000000000000001
1M00000000000C00010000000M000M00001
10000000000M0000010000C000000000001
1000000000000000010000000000000C001
11111111111111111111111111111111111
