111111111111111111111111111111111111111111111111111
10000000CM000000000M00000M1000M0000C000000C00000001
1CC0000M00000000MC00000001100M0000C00000M00000M0001
1000000M000000M00C00000001100M000C000000M0E00001111
111111111111111C0M0M0M01111111111C0000000M000C00001
111C0000000000000000000C00000000000000000M000000001
1C10M0100000000000000000000000000M0000000000M00M0M1
100000000000000000M00000000000000000000C000000000P1
111111111111111111111111111111111111111111111111111
